//MAP CONVERTED BY dmm2tgm.py THIS HEADER COMMENT PREVENTS RECONVERSION, DO NOT REMOVE
"as" = (
/obj/structure/fluff/railing/border,
/turf/open/floor/rogue/ruinedwood,
/area/rogue/under/tomb/cave)
"cl" = (
/obj/structure/table/wood{
	icon_state = "tablewood1"
	},
/turf/open/floor/rogue/ruinedwood,
/area/rogue/under/tomb/cave)
"fZ" = (
/mob/living/carbon/human/species/orc/npc/footsoldier,
/turf/open/floor/rogue/dirt/road,
/area/rogue/under/tomb/cave)
"hr" = (
/obj/structure/fluff/railing/border{
	dir = 5
	},
/mob/living/carbon/human/species/orc/npc/marauder,
/turf/open/floor/rogue/ruinedwood,
/area/rogue/under/tomb/cave)
"ih" = (
/obj/structure/fluff/railing/border{
	dir = 4;
	pixel_x = 0;
	pixel_y = 0
	},
/turf/open/floor/rogue/ruinedwood,
/area/rogue/under/tomb/cave)
"ji" = (
/obj/structure/table/wood{
	icon_state = "tablewood1"
	},
/obj/machinery/light/rogue/candle,
/turf/open/floor/rogue/ruinedwood,
/area/rogue/under/tomb/cave)
"mA" = (
/obj/structure/chair/wood/rogue/throne,
/obj/item/clothing/ring/active/nomag,
/mob/living/carbon/human/species/orc/npc/berserker{
	health = 650;
	name = "Orc Chief"
	},
/turf/open/floor/rogue/ruinedwood,
/area/rogue/under/tomb/cave)
"ni" = (
/turf/open/floor/rogue/dirt,
/area/rogue/under/tomb/cave)
"pF" = (
/obj/structure/fluff/railing/border{
	dir = 6
	},
/mob/living/carbon/human/species/orc/npc/marauder,
/turf/open/floor/rogue/ruinedwood,
/area/rogue/under/tomb/cave)
"qI" = (
/obj/structure/table/wood{
	icon_state = "tablewood1"
	},
/obj/item/roguegem/diamond{
	pixel_y = -5
	},
/obj/item/roguegem/violet{
	pixel_y = 7;
	pixel_x = -9
	},
/obj/item/roguegem/ruby{
	pixel_y = -6;
	pixel_x = -9
	},
/obj/item/roguegem/green{
	pixel_y = -5;
	pixel_x = 11
	},
/obj/item/roguegem/blue{
	pixel_y = 12
	},
/obj/item/roguegem/amethyst{
	pixel_y = 11;
	pixel_x = 14
	},
/obj/item/roguegem/random,
/turf/open/floor/rogue/ruinedwood,
/area/rogue/under/tomb/cave)
"qW" = (
/mob/living/carbon/human/species/orc/npc/footsoldier,
/turf/open/floor/rogue/dirt,
/area/rogue/under/tomb/cave)
"tg" = (
/obj/item/flint{
	pixel_y = 4;
	pixel_x = -6
	},
/obj/structure/table/wood/crafted,
/obj/item/clothing/mask/rogue/ragmask,
/turf/open/floor/rogue/ruinedwood,
/area/rogue/under/tomb/cave)
"tP" = (
/turf/closed/wall/mineral/rogue/decowood,
/area/rogue/under/tomb/cave)
"vi" = (
/turf/open/transparent/openspace,
/area/rogue/under/tomb/cave)
"vl" = (
/obj/machinery/light/rogue/campfire/densefire,
/turf/open/floor/rogue/dirt,
/area/rogue/under/tomb/cave)
"vD" = (
/obj/structure/roguetent,
/turf/open/floor/rogue/dirt,
/area/rogue/under/tomb/cave)
"vF" = (
/obj/item/rogueweapon/shovel,
/turf/open/floor/rogue/dirt,
/area/rogue/under/tomb/cave)
"wr" = (
/obj/structure/toilet,
/obj/item/natural/poo{
	pixel_y = 9
	},
/obj/item/natural/poo{
	pixel_y = -4;
	pixel_x = 6
	},
/obj/item/natural/poo{
	pixel_x = -4
	},
/mob/living/carbon/human/species/orc/npc/footsoldier,
/turf/open/floor/rogue/dirt,
/area/rogue/under/tomb/cave)
"wJ" = (
/obj/machinery/light/rogue/candle/l,
/turf/open/floor/rogue/ruinedwood,
/area/rogue/under/tomb/cave)
"BM" = (
/obj/structure/ladder,
/turf/open/floor/rogue/naturalstone,
/area/rogue/under/tomb/cave)
"Cg" = (
/obj/structure/closet/dirthole/grave,
/turf/open/floor/rogue/dirt,
/area/rogue/under/tomb/cave)
"Cn" = (
/obj/structure/table/wood/crafted,
/obj/item/clothing/mask/cigarette/rollie/nicotine{
	pixel_y = -14
	},
/obj/item/clothing/mask/rogue/skullmask{
	pixel_y = 7
	},
/turf/open/floor/rogue/ruinedwood,
/area/rogue/under/tomb/cave)
"CV" = (
/mob/living/carbon/human/species/orc/npc/marauder,
/turf/open/floor/rogue/dirt/road,
/area/rogue/under/tomb/cave)
"Dd" = (
/obj/structure/roguewindow,
/turf/open/floor/rogue/ruinedwood,
/area/rogue/under/tomb/cave)
"DD" = (
/obj/structure/table/wood{
	dir = 1;
	icon_state = "longtable"
	},
/turf/open/floor/rogue/ruinedwood,
/area/rogue/under/tomb/cave)
"EU" = (
/obj/structure/fluff/walldeco/innsign{
	pixel_x = 32
	},
/turf/open/floor/rogue/dirt,
/area/rogue/under/tomb/cave)
"Fq" = (
/turf/closed/mineral/rogue/bedrock,
/area/rogue/under/tomb/cave)
"Fr" = (
/obj/item/clothing/shoes/roguetown/boots/nobleboot,
/turf/open/floor/rogue/ruinedwood,
/area/rogue/under/tomb/cave)
"FC" = (
/obj/machinery/light/rogue/firebowl,
/turf/open/floor/rogue/dirt,
/area/rogue/under/tomb/cave)
"Ha" = (
/obj/structure/ladder,
/obj/structure/ladder,
/turf/open/floor/rogue/dirt,
/area/rogue/under/tomb/cave)
"Hr" = (
/mob/living/carbon/human/species/orc/npc/marauder,
/obj/structure/chair/stool/rogue,
/turf/open/floor/rogue/ruinedwood,
/area/rogue/under/tomb/cave)
"HV" = (
/turf/open/floor/rogue/naturalstone,
/area/rogue/under/tomb/cave)
"If" = (
/obj/structure/mineral_door/wood/window,
/turf/open/floor/rogue/ruinedwood,
/area/rogue/under/tomb/cave)
"Ig" = (
/obj/structure/stairs,
/turf/open/floor/rogue/ruinedwood,
/area/rogue/under/tomb/cave)
"IJ" = (
/obj/structure/chair/stool/rogue,
/mob/living/carbon/human/species/orc/npc/berserker,
/turf/open/floor/rogue/dirt,
/area/rogue/under/tomb/cave)
"Kd" = (
/obj/structure/fermentation_keg/random/beer,
/turf/open/floor/rogue/dirt,
/area/rogue/under/tomb/cave)
"KW" = (
/obj/machinery/light/rogue/oven/south,
/turf/open/floor/rogue/ruinedwood,
/area/rogue/under/tomb/cave)
"Lj" = (
/obj/structure/bed/rogue/shit,
/mob/living/simple_animal/hostile/retaliate/rogue/orc,
/turf/open/floor/rogue/dirt,
/area/rogue/under/tomb/cave)
"Ln" = (
/turf/closed/wall/mineral/rogue/tent,
/area/rogue/under/tomb/cave)
"MQ" = (
/obj/structure/closet/dirthole/closed/loot,
/turf/open/floor/rogue/dirt,
/area/rogue/under/tomb/cave)
"NI" = (
/mob/living/carbon/human/species/orc/npc/berserker,
/turf/open/floor/rogue/ruinedwood,
/area/rogue/under/tomb/cave)
"OX" = (
/obj/structure/gate/bars/preopen,
/turf/open/floor/rogue/dirt/road,
/area/rogue/under/tomb/cave)
"PN" = (
/turf/open/floor/rogue/ruinedwood,
/area/rogue/under/tomb/cave)
"PP" = (
/obj/structure/fluff/railing/fence,
/turf/open/floor/rogue/dirt,
/area/rogue/under/tomb/cave)
"Rc" = (
/obj/structure/closet/crate/chest/wicker,
/obj/item/clothing/shoes/roguetown/boots/nobleboot,
/obj/item/clothing/head/roguetown/grenzelhofthat,
/obj/item/clothing/cloak/half/rider,
/obj/item/clothing/suit/roguetown/armor/leather/vest/black,
/turf/open/floor/rogue/ruinedwood,
/area/rogue/under/tomb/cave)
"Ro" = (
/obj/machinery/light/rogue/candle{
	pixel_y = 0;
	pixel_x = 32
	},
/turf/open/floor/rogue/ruinedwood,
/area/rogue/under/tomb/cave)
"Ug" = (
/obj/item/reagent_containers/glass/cup/skull{
	pixel_x = -9
	},
/obj/item/reagent_containers/glass/cup/wooden/crafted{
	pixel_y = -10;
	pixel_x = 11
	},
/obj/item/reagent_containers/glass/cup/wooden/crafted{
	pixel_y = 13;
	pixel_x = 12
	},
/turf/open/floor/rogue/dirt/road,
/area/rogue/under/tomb/cave)
"Wm" = (
/obj/structure/table/wood{
	icon_state = "longtable"
	},
/obj/item/clothing/neck/roguetown/collar/bell_collar,
/turf/open/floor/rogue/ruinedwood,
/area/rogue/under/tomb/cave)
"XK" = (
/turf/closed/wall/mineral/rogue/wooddark,
/area/rogue/under/tomb/cave)
"Yl" = (
/obj/structure/chair/stool/rogue,
/turf/open/floor/rogue/ruinedwood,
/area/rogue/under/tomb/cave)
"Ze" = (
/turf/open/floor/rogue/dirt/road,
/area/rogue/under/tomb/cave)
"ZQ" = (
/obj/structure/chair/stool/rogue,
/turf/open/floor/rogue/dirt,
/area/rogue/under/tomb/cave)

(1,1,1) = {"
Fq
Fq
Fq
Fq
Fq
Fq
Fq
Fq
Fq
Fq
Fq
Fq
Fq
Fq
Fq
Fq
Fq
Fq
Fq
Fq
"}
(2,1,1) = {"
Fq
ni
ni
ni
ni
ni
ni
ni
PP
ni
Ln
Ln
Ln
Ln
Ln
Ln
Ln
Ln
Ln
Fq
"}
(3,1,1) = {"
Fq
ni
MQ
Cg
MQ
Cg
MQ
ni
PP
ni
Ln
Lj
Ln
Ln
Lj
Ln
Ln
Lj
Ln
Fq
"}
(4,1,1) = {"
Fq
ni
ni
ni
vF
ni
ni
ni
PP
ni
Ln
vD
Ln
Ln
vD
Ln
Ln
vD
Ln
Fq
"}
(5,1,1) = {"
Fq
ni
MQ
Cg
MQ
MQ
MQ
ni
PP
ni
ni
Ze
Ze
Ze
Ze
Ze
Ze
Ze
ni
Fq
"}
(6,1,1) = {"
Fq
Ha
ni
ni
ni
ni
ni
ni
PP
ni
ni
ni
ni
Ze
ni
IJ
ni
Ze
ni
Fq
"}
(7,1,1) = {"
Fq
ni
ni
ni
ni
ni
ni
ni
PP
ni
ni
ni
ni
Ze
IJ
vl
ZQ
Ze
ni
Fq
"}
(8,1,1) = {"
Fq
ni
ni
ni
ni
FC
ni
qW
PP
FC
ni
ni
ni
Ze
ni
ZQ
ni
Ze
ni
Fq
"}
(9,1,1) = {"
Fq
Ze
Ze
Ze
Ze
Ze
Ze
Ze
OX
Ze
Ze
Ze
Ze
Ze
Ze
Ze
fZ
Ug
Kd
Fq
"}
(10,1,1) = {"
Fq
Ze
Ze
Ze
Ze
Ze
Ze
Ze
Ze
Ze
Ze
Ze
Ze
Ze
Ze
CV
Ze
Ze
ni
Fq
"}
(11,1,1) = {"
Fq
Ze
Ze
Ze
Ze
Ze
Ze
Ze
Ze
Ze
Ze
Ze
Ze
Ze
Ze
Ze
Ze
Ze
ni
Fq
"}
(12,1,1) = {"
Fq
ni
ni
ni
ni
FC
ni
qW
PP
FC
ni
EU
Ze
EU
ni
ni
ni
ni
ni
Fq
"}
(13,1,1) = {"
Fq
ni
ni
ni
ni
ni
ni
ni
PP
ni
ni
XK
If
XK
tP
tP
tP
tP
XK
Fq
"}
(14,1,1) = {"
Fq
ni
ni
ni
ni
ni
ni
ni
PP
ni
ni
tP
PN
PN
Yl
Yl
wJ
NI
tP
Fq
"}
(15,1,1) = {"
Fq
ni
ni
ni
ni
ni
ni
ni
PP
ni
ni
tP
Fr
PN
Cn
tg
PN
PN
tP
Fq
"}
(16,1,1) = {"
Fq
ni
ni
ni
ni
ni
ni
ni
PP
ni
ni
tP
KW
PN
Hr
Yl
Ro
PN
tP
Fq
"}
(17,1,1) = {"
Fq
Ln
vD
Ln
ni
ni
ni
ni
PP
ni
ni
tP
Wm
PN
PN
Ig
tP
PN
tP
Fq
"}
(18,1,1) = {"
Fq
Ln
wr
Ln
ni
ni
ni
ni
PP
ni
ni
tP
DD
PN
PN
Ig
tP
Rc
tP
Fq
"}
(19,1,1) = {"
Fq
Ln
Ln
Ln
ni
ni
ni
ni
PP
ni
ni
XK
tP
tP
tP
tP
XK
tP
XK
Fq
"}
(20,1,1) = {"
Fq
Fq
Fq
Fq
Fq
Fq
Fq
Fq
Fq
Fq
Fq
Fq
Fq
Fq
Fq
Fq
Fq
Fq
Fq
Fq
"}

(1,1,2) = {"
Fq
Fq
Fq
Fq
Fq
Fq
Fq
Fq
Fq
Fq
Fq
Fq
Fq
Fq
Fq
Fq
Fq
Fq
Fq
Fq
"}
(2,1,2) = {"
Fq
vi
vi
vi
vi
vi
vi
vi
vi
vi
Ln
Ln
Ln
Ln
Ln
Ln
Ln
Ln
Ln
Fq
"}
(3,1,2) = {"
Fq
vi
vi
vi
vi
vi
vi
vi
vi
vi
Ln
Ln
Ln
Ln
Ln
Ln
Ln
Ln
Ln
Fq
"}
(4,1,2) = {"
Fq
vi
vi
vi
vi
vi
vi
vi
vi
vi
Ln
Ln
Ln
Ln
Ln
Ln
Ln
Ln
Ln
Fq
"}
(5,1,2) = {"
Fq
vi
vi
vi
vi
vi
vi
vi
vi
vi
vi
vi
vi
vi
vi
vi
vi
vi
vi
Fq
"}
(6,1,2) = {"
Fq
BM
vi
vi
vi
vi
vi
vi
vi
vi
vi
vi
vi
vi
vi
vi
vi
vi
vi
Fq
"}
(7,1,2) = {"
Fq
HV
vi
vi
vi
vi
vi
vi
vi
vi
vi
vi
vi
vi
vi
vi
vi
vi
vi
Fq
"}
(8,1,2) = {"
Fq
HV
vi
vi
vi
vi
vi
vi
vi
vi
vi
vi
vi
vi
vi
vi
vi
vi
vi
Fq
"}
(9,1,2) = {"
HV
HV
vi
vi
vi
vi
vi
vi
vi
vi
vi
vi
vi
vi
vi
vi
vi
vi
vi
Fq
"}
(10,1,2) = {"
HV
HV
vi
vi
vi
vi
vi
vi
vi
vi
vi
vi
vi
vi
vi
vi
vi
vi
vi
Fq
"}
(11,1,2) = {"
HV
HV
vi
vi
vi
vi
vi
vi
vi
vi
vi
vi
vi
vi
vi
vi
vi
vi
vi
Fq
"}
(12,1,2) = {"
Fq
HV
vi
vi
vi
vi
vi
vi
vi
vi
vi
vi
vi
vi
vi
vi
vi
vi
vi
Fq
"}
(13,1,2) = {"
Fq
HV
vi
vi
vi
vi
vi
vi
vi
vi
vi
XK
tP
Dd
tP
tP
Dd
tP
XK
Fq
"}
(14,1,2) = {"
Fq
HV
vi
vi
vi
vi
vi
vi
vi
vi
vi
tP
qI
PN
PN
PN
PN
PN
tP
Fq
"}
(15,1,2) = {"
Fq
vi
vi
vi
vi
vi
vi
vi
vi
vi
vi
tP
ji
PN
PN
PN
PN
PN
tP
Fq
"}
(16,1,2) = {"
Fq
vi
vi
vi
vi
vi
vi
vi
vi
vi
vi
tP
mA
PN
pF
ih
ih
hr
tP
Fq
"}
(17,1,2) = {"
Fq
Ln
Ln
Ln
vi
vi
vi
vi
vi
vi
vi
tP
ji
PN
as
vi
Ig
PN
tP
Fq
"}
(18,1,2) = {"
Fq
Ln
Ln
Ln
vi
vi
vi
vi
vi
vi
vi
tP
cl
PN
as
vi
Ig
PN
tP
Fq
"}
(19,1,2) = {"
Fq
Ln
Ln
Ln
vi
vi
vi
vi
vi
vi
vi
XK
tP
tP
tP
tP
tP
tP
XK
Fq
"}
(20,1,2) = {"
Fq
Fq
Fq
Fq
Fq
Fq
Fq
Fq
Fq
Fq
Fq
Fq
Fq
Fq
Fq
Fq
Fq
Fq
Fq
Fq
"}
